#G##############
#..............#
####.#########.#
#....###.......#
#.##.###.##.####
#.##.###..#.####
#.#########....#
#......#.#####.#
#.######.#####.#
#.#...#...S..#.#
###.#.######.#.#
#.#.#........#.#
#.#.########.#.#
#.##########.#.#
#..............#
################