#G#######
#.......#
###.#.###
###.#...#
#...###.#
#.###...#
#.#S###.#
#.#.....#
#########